████████████████████████████████████████████████████████████
█░░░░░░░░░░░░░░░░░░░░░░░░░░░║─║░░░░░░░░░░░░░░░░░░░░░░░░░░░░█
█░░░░░░░░░░░░░░░░░░░░░░░░░░░╚═╝░░░░░░░░░░░░░░░░░░░░░░░░░░░░█
█░░░░░░░░░░░░░░░░░░░░░░░░░░░░░░░░░░░░░░░░░░░░░░░░░░░░░░░░░░█
█░╔═╗*░░░░░░░░░░░░░░░░░░░░░░░░░░░░░░░░░░░░░░░░░░░░░░░░░░░░░█
█░║─║░░░░░░░░░░░░░░░░░░░░░░░░░░░░░░░░░░░░░░░░░░░░░░░░░░░░░░█
█░║─║░░░░░░░░░░░░░░░░░░░░░░░░░░░░░░░░░░░░░░░░░░░░░░░░░░░░░░█
█░║T║░░░░░░░░░░░░░░░░░░░░░░░░░░░░░░░░░░░░░░░░░░░░░░░░░░░░░░█
█░╚═╝░░░░░░░░░░░░░░░░░░░░░░░░░░░░░░░░░░░░░░░░░░░░░░░░░░░░░░█
█░░░▒░░░▒░░░░░░░░░░░░░░░░░░░░░░░░░░░░░░░░░░░████████████████
█░░▒░▒┬▒░▒░░░░░░░░░░░░░░░░░░░░░░░░░░░░░░░░░░█:::::::▌::::::█
█░░░▄▀▀▀▄░░░░░░░░░░░░░░░░░░░░░░░░░░░░░░░░░░░█:::::::▌::::::█
█░░▐▒▒└▒▒▌░░░░░░░░░░░░░░░░░░░░░░░░░░░░░░░░░░█:::::::▌::::::█
█░░░▀▄▄▄▀░░░░░░░░░░░░░░░░░░░░░░░░░░░░░░░░░░░█:::::::▌::::::█
███████████████████░░░░░░░░░░░░░░░░░░░░░░░░░█:::::::▌::::::█
█░░░░░░░░░░░░░░░░░░░░░░░░░░░░░░░░░░░░░░░░░░░█▄▄▄▄▄▄▄▄▄▄▄▄▄▄█
███░░░░░░░░░░░░░░░░░░░░░░░░░░░░░░░░░░░░░░░░░█:::::::▌::::▀▀█
█████████░░░░░░░░░░░░░░░░░░░░░░░░░░░░░░░░░░░█:::::::▌::::::█
███████████████████████████░░░░░░░░░░░░░░░░░█:::::::▌::::::█
███████████████████████████░░▄▄▄▌▀▀▀▀\▄▄▄░░░█:::::::▌::::::█
█░░████░░░░░░░░░░░░░░████░░░░▌ ▄▄  ▌  ▄▄ └▄░█:::::::▌::::::█
█░░██░░░░░░░░░░░░░░░░░░██░░░░▀▀▄▄▀▀▀▀▀▄▄▀▀░░█:::::::▌::::::█
████████████████████████████████████████████████████████████