████████████████████████████████████████████████████████████
█░░░░░░░░░░░░░░░░░░░░░░░░░░░║─║░░░░░░░░░░░░░░░░░░░░░░░░░░░░█
█░░░░░░░░░░░░░░░░░░░░░░░░░░░╚═╝░░░░░░░░░░░░░░░░░░░░░░░░░░░░█
█░░░░░░░░░░░░░░░░░░░░░░░░░░░░░░░░░░░░░░░░░░░░░░░░░░░░░░░░░░█
█░╔═╗*░░░░░░░░░░░░░░░░░░░░░░░░░░░░░░░░░░░░░░░░░░░░░░░░░░░░░█
█░║─║░░░░░░░░░░░░░░░░░░░░░░░░░░░░░░░░░░░░░░░░░░░░░░░░░░░░░░█
█░║─║░░░░░░░░░░░░░░░░░░░░░░░░░░░░░░░░░░░░░░░░░░░░░░░░░░░░░░█
█░║T║░░░░░░░░░░░░░░░░░░░░░░░░░░░░░░░░░░░░░░░░░░░░░░░░░░░░░░█
█░╚═╝░░░░░░░░░░░░░░░░▀▄▀░░░░░░░░░░░░░░░░░░░░░░░░░░░░░░░░░░░█
█░░░░░░░░░░░░░░░░░░░▄▀▀▀▄░░░░░░░░░░░░░░░░░░░████████████████
█░░░░░░░░░░░░░░░█▀▀▀▀▀▀▀▀▀▀▀█░░░░▄▄▀▀▀▀▄▄░░░█:::::::▌::::::█
█░░░░░░░░░░░░░░░█▓▓▓▓▓▓▓▓▓▓▓█░░░░░▐    ▌░▀▄░█:::::::▌::::::█
█░█▀▀▀▀▀▀▀▀▀▀▀█░█▓▓▓▓▓▓▓▓▓▓▓█░░░░▐======▌░░░█:::::::▌::::::█
█░█           █░█▄▄▄▄▄▄▄▄▄▄▄█░░░░▐======▌░░░█:::::::▌::::::█
█░█           █░░░░░░░░░░░░░░░░░░▐======▌░░░█:::::::▌::::::█
█░█▄▄▄▄▄▄▄▄▄▄▄█░░░░░░░░░░░░░░░░░░▐▄▄▄▄▄▄▌░░░█▄▄▄▄▄▄▄▄▄▄▄▄▄▄█
█░█▀          █░██████████████████████████░░█:::::::▌::::▀▀█
█░█           █░██▒▒▒▒▒▒▒▒▒▒██     ▌    ██░░█:::::::▌::::::█
█░█           █░██ ▄▄▄▄▄▄▄▄ ██     ▌    ██░░█:::::::▌::::::█
█░█           █░██▒▒▒▒▀▀▒▒▒▒██    -▌-   ██░░█:::::::▌::::::█
█░█           █░██▒▒▒▒▒▒▒▒▒▒██     ▌    ██░░█:::::::▌::::::█
█░█           █░██▒▒▒▒▒▒▒▒▒▒██     ▌    ██░░█:::::::▌::::::█
████████████████████████████████████████████████████████████