████████████████████████████████████████████████████████████
█░░░░░░░░░░░░░░░░░░░░░░░░░░░║─║░░░░░░░░░░░░░░░░░░░░░░░░░░░░█
█░░░░░░░░░░░░░░░░░░░░░░░░░░░╚═╝░░░░░░░░░░░░░░░░░░░░░░░░░░░░█
█░░░░░░░░░░░░░░░░░░░░░░░░░░░░░░░░░░░░░░░░░░░░░░░░░░░░░░░░░░█
█░╔═╗*░░░░░░░░░░░░░░░░░░░░░░░░░░░░░░░░░░░░░░░░░░░░░░░░░░░░░█
█░║─║░░░░░░░░░░░░░░░░░░░░░░░░░░░░░░░░░░░░░░░░░░░░░░░░░░░░░░█
█░║─║░░░░░░░░░░░░░░░░░░░░░░░░░░░░░░░░░░░░░░░░░░░░░░░░░░░░░░█
█░║T║░░░░░░░░░░░░░░░░░░░░░░░░░░░░░░░░░░░░░░░░░░░░░░░░░░░░░░█
█░╚═╝░░░░░░░░░░░░░░░░░░░░░░░░░░░░░░░░░░░░░░░░░░░░░░░░░░░░░░█
█░░░░░░░░░░░░░░░░░░░░░░░░░░░░░░░░░░░░░░░░░░░████████████████
█░███████████████████████████████░░░░░░░░░░░█▓▓▓▓▓▓|▓▓▓▓▓▓▓█
█░██▒▒▒▒▒▒▒▒▒▒▒▒▒▒▒▒▒▒▒▒▒▒▒▒▒▒▒██░░░░░░░░░░░█▓▓▓▓▓▓|▓▓▓▓▓▓▓█
█░██▒▒▒▒▒▒▒▒▒▒▒▒▒▒▒▒▒▒▒▒▒▒▒▒▒▒▒██░░░░░░░░░░░█▓▓▓▓▓▓|▓▓▓▓▓▓▓█
█░██▒▒▒▒▒▒▒▒▒▒▒▒▒▒▒▒▒▒▒▒▒▒▒▒▒▒▒██░░░░░░░░░░░█▓▓▓▓▓▓|▓▓▓▓▓▓▓█
█░██▒▒▒▒▒▒▒▒▒▒▒▒▒▒▒▒▒▒▒▒▒▒▒▒▒▒▒██░░░░░░░░░░░█▓▓▓▓▓▓|▓▓▓▓▓▓▓█
█░██▒▒▒▒▒▒▒▒▒▒▒▒▒▒▒▒▒▒▒▒▒▒▒▒▒▒▒██░░░░░░░░░░░█ ------------ █
█░██▒▒▒▒▒▒▒▒▒▒▒▒▒▒▒▒▒▒▒▒▒▒▒▒▒▒▒██░░░░░░░░░░░█▓▓▓▓▓▓|▓▓▓▓▓▓▓█
█░███████████████████████████████░░░░░░░░░░░█▓▓▓▓▓▓|▓▓▓▓▓▓▓█
█░░░░░░░░░░░████TV████░░░░░░░░░░░░░░░░░░░░░░█▓▓▓▓▓▓|▓▓▓▓▓▓▓█
█░░░░░░░░░█░██████████░█░░░░░░░░░░░░░░░░░░░░█▓▓▓▓▓▓|▓▓▓▓▓▓▓█
█░░░░░░░░░██████████████░░░░░░░░░░░░░░░░░░░░█▓▓▓▓▓▓|▓▓▓▓▓▓▓█
████████████████████████████████████████████████████████████